Flow ID,Src IP,Src Port,Dst IP,Dst Port,Protocol,Timestamp,Flow Duration,Total Fwd Packet,Total Bwd packets,Total Length of Fwd Packet,Total Length of Bwd Packet,Fwd Packet Length Max,Fwd Packet Length Min,Fwd Packet Length Mean,Fwd Packet Length Std,Bwd Packet Length Max,Bwd Packet Length Min,Bwd Packet Length Mean,Bwd Packet Length Std,Flow Bytes/s,Flow Packets/s,Flow IAT Mean,Flow IAT Std,Flow IAT Max,Flow IAT Min,Fwd IAT Total,Fwd IAT Mean,Fwd IAT Std,Fwd IAT Max,Fwd IAT Min,Bwd IAT Total,Bwd IAT Mean,Bwd IAT Std,Bwd IAT Max,Bwd IAT Min,Fwd PSH Flags,Bwd PSH Flags,Fwd URG Flags,Bwd URG Flags,Fwd Header Length,Bwd Header Length,Fwd Packets/s,Bwd Packets/s,Packet Length Min,Packet Length Max,Packet Length Mean,Packet Length Std,Packet Length Variance,FIN Flag Count,SYN Flag Count,RST Flag Count,PSH Flag Count,ACK Flag Count,URG Flag Count,CWR Flag Count,ECE Flag Count,Down/Up Ratio,Average Packet Size,Fwd Segment Size Avg,Bwd Segment Size Avg,Fwd Bytes/Bulk Avg,Fwd Packet/Bulk Avg,Fwd Bulk Rate Avg,Bwd Bytes/Bulk Avg,Bwd Packet/Bulk Avg,Bwd Bulk Rate Avg,Subflow Fwd Packets,Subflow Fwd Bytes,Subflow Bwd Packets,Subflow Bwd Bytes,FWD Init Win Bytes,Bwd Init Win Bytes,Fwd Act Data Pkts,Fwd Seg Size Min,Active Mean,Active Std,Active Max,Active Min,Idle Mean,Idle Std,Idle Max,Idle Min,Label
192.168.1.4-192.168.1.5-49171-445-6,192.168.1.4,49171,192.168.1.5,445,6,01/01/1970 08:01:19 AM,11711653,25,22,3166.0,3408.0,497.0,0.0,126.63999999999993,101.37302402513203,524.0,0.0,154.9090909090909,129.38827101142002,561.3212754851941,4.01309704104109,254601.152173913,1667347.5210515114,1.131405E7,169.0,1.1711653E7,487985.5416666666,2306601.0717979744,1.131405E7,496.0,1.1710289E7,557632.8095238095,2527021.880140863,1.1586379E7,434.0,0,0,0,0,512,452,2.134626085660154,1.8784709553809356,0.0,524.0,136.95833333333334,115.47422266155674,13334.296099290785,0,2,1,42,46,0,0,0,0.0,139.87234042553192,126.64,154.9090909090909,0,0,0,3287,21,53297,25,3166,22,3408,8192,256,21,20,392769.0,0.0,392769.0,392769.0,1.131405E7,0.0,1.131405E7,1.131405E7,1
192.168.1.4-192.168.1.5-49175-445-6,192.168.1.4,49175,192.168.1.5,445,6,01/01/1970 08:01:43 AM,119999418,432719,441624,5.61225433E8,5.64164961E8,1460.0,0.0,1296.9743251394152,451.7101894067312,1460.0,0.0,1277.4780378783428,470.67997960896867,9378298.768082358,7286.22700486764,137.2454005412088,2663.110331378921,675069.0,0.0,1.19999283E8,277.31520990575757,4439.04360783068,889239.0,0.0,1.19999164E8,271.72308507482967,3809.519498264565,675069.0,0.0,0,0,0,0,8654388,8832500,3606.009155811072,3680.217849056568,0.0,1460.0,1287.125426605525,461.4936598982934,212976.3981263217,0,2,0,48723,874342,0,0,0,1.0,1287.1268987113754,1296.974325139409,1277.4780378783762,0,0,0,1125390394,800240,9378341,0,0,0,0,8192,63070,398904,20,0,0,0,0,0,0,0,0,1
192.168.1.4-192.168.1.5-49175-445-6,192.168.1.4,49175,192.168.1.5,445,6,01/01/1970 08:03:43 AM,119974908,316587,323870,4.12501579E8,4.08021861E8,1460.0,0.0,1302.964363666233,442.6289005726044,1460.0,0.0,1259.832219717782,488.74273049060656,6839125.394453313,5338.257896392803,187.3273230323394,5211.831101239092,2014232.0,0.0,1.19974908E8,378.9646667888049,8234.783171047424,2223248.0,0.0,1.19972211E8,370.4343762447131,7401.714094145093,2014232.0,0.0,0,0,0,0,6331764,6477400,2638.776768222235,2699.481128170567,0.0,1460.0,1281.1510512789878,467.0182209581776,218106.01870694122,0,0,0,39021,640457,0,0,0,1.0,1281.1530516490568,1302.9643636662277,1259.832219717788,0,0,0,117217634,83792,7400038,79146,103125394,80967,102005465,64240,63090,294683,20,0,0,0,0,0,0,0,0,1
192.168.1.4-192.168.1.5-49175-445-6,192.168.1.4,49175,192.168.1.5,445,6,01/01/1970 08:05:43 AM,119971922,444505,457510,5.78757739E8,5.77806399E8,1460.0,0.0,1302.0275115015102,444.39382155062367,1460.0,0.0,1262.9372013726245,484.78314687932465,9640290.15055706,7518.550882263935,133.0045010387886,2450.809183345625,714238.0,0.0,1.19971922E8,269.9006578118555,4000.2973521492513,861381.0,0.0,1.19971446E8,262.22751027848426,3484.8961517214957,714238.0,0.0,0,0,0,0,8890100,9150200,3705.07525919273,3813.4756230712046,0.0,1460.0,1282.2007569709883,465.72772453467775,216902.31340024868,0,0,0,53593,902015,0,0,0,1.0,1282.2021784560125,1302.027511501558,1262.9372013726477,0,0,0,1156564138,825612,9640290,0,0,0,0,62973,63108,412952,20,0,0,0,0,0,0,0,0,1
192.168.1.4-192.168.1.5-49175-445-6,192.168.1.4,49175,192.168.1.5,445,6,01/01/1970 08:07:43 AM,119979099,513716,531604,6.76242853E8,6.76415248E8,1460.0,0.0,1316.3749094830193,427.6991213057813,1460.0,0.0,1272.4043611410145,479.8715535133745,1.1274114510561543E7,8712.517502736038,114.7774975868632,2765.827692545335,1279852.0,0.0,1.19976324E8,233.54646837254464,4435.521825682179,1283317.0,0.0,1.19979004E8,225.69286478819615,4110.13470073878,1495507.0,0.0,0,0,0,0,10274320,10632092,4281.712433929846,4430.805068806192,0.0,1460.0,1294.0135719076106,455.5102676558487,207489.60393990288,0,0,0,51477,1045320,0,0,0,1.0,1294.0148098190027,1316.3749094830607,1272.4043611409998,0,0,0,338164525,238888,11660002,171238,225414284,177201,225471749,62991,64240,477659,20,0,0,0,0,0,0,0,0,1
192.168.1.4-192.168.1.5-49175-445-6,192.168.1.4,49175,192.168.1.5,445,6,01/01/1970 08:09:43 AM,60289021,171392,174541,2.21347871E8,2.20103102E8,1460.0,0.0,1291.4714280713251,458.5816637079728,1460.0,0.0,1261.0395379882555,490.9105281973694,7322244.841229052,5737.910390019437,174.27997698970074,4107.395572688555,1203257.0,0.0,6.0288475E7,351.7598648703779,6353.479599266524,1203257.0,0.0,6.0288968E7,345.4163400939583,6997.610180379503,2106114.0,0.0,0,0,0,0,3430616,3490820,2842.839328905341,2895.0710611140958,0.0,1460.0,1276.1175050732506,475.41051218108623,226015.15509228272,0,0,1,18837,345932,0,0,0,1.0,1276.1211939884313,1291.471428071322,1261.039537988209,0,0,0,441450856,313670,7471426,171392,221347871,174541,220103102,64240,0,157166,20,0,0,0,0,0,0,0,0,1
192.168.1.4-192.168.1.5-49206-445-6,192.168.1.4,49206,192.168.1.5,445,6,01/01/1970 08:10:44 AM,119983159,231824,231614,2.98720644E8,2.98059178E8,1460.0,0.0,1288.5665159776458,460.2463820959987,1460.0,0.0,1286.878936506416,453.46056495403906,4973863.223587904,3862.525406586436,258.8985320550744,7135.154392630834,2681928.0,0.0,1.19983159E8,517.5636541671938,11627.27912350912,2884866.0,0.0,1.19981878E8,518.0273905178087,10184.399762890493,2681928.0,0.0,0,0,0,0,4640872,4642456,1932.1378261094126,1930.3875804770234,0.0,1460.0,1287.720329967905,456.87131906152325,208731.40218101616,0,2,0,30072,463437,0,0,0,0.0,1287.7231085927351,1288.5665159776381,1286.8789365064288,0,0,0,74597477,53521,5462886,46364,59744128,46322,59611835,8192,1358,214020,20,0,0,0,0,0,0,0,0,1
192.168.1.4-192.168.1.5-49206-445-6,192.168.1.4,49206,192.168.1.5,445,6,01/01/1970 08:12:44 AM,119862293,630052,654380,8.41091506E8,8.62634406E8,1460.0,0.0,1334.9556957202974,403.2959410901562,1460.0,0.0,1318.2468993550783,427.5531446594896,1.4214027358879244E7,10715.897117035798,93.31937098995576,2922.657059927495,1256823.0,0.0,1.19862293E8,190.24220737686417,4387.873645732741,1259932.0,0.0,1.19862166E8,183.1693345905014,4180.713279406255,1256823.0,0.0,0,0,0,0,12607340,13110112,5256.465434046052,5459.431682989746,0.0,1460.0,1326.443163637216,415.91469737809354,172985.0354951111,0,0,0,51113,1284432,0,0,0,1.0,1326.444196345155,1334.9556957203533,1318.2468993551147,0,0,0,567908637,397172,14490805,630052,841091506,654380,862634406,1357,2440,588219,20,0,0,0,0,0,0,0,0,1
192.168.1.4-192.168.1.5-49206-445-6,192.168.1.4,49206,192.168.1.5,445,6,01/01/1970 08:14:44 AM,119999999,156565,144139,2.05582835E8,1.8316585E8,1460.0,0.0,1313.082968735043,430.7663527949517,1460.0,0.0,1270.7584345666203,477.09553048378143,3239572.4019964365,2505.866687548889,399.06485469050574,20337.402277928013,5009694.0,0.0,1.19998892E8,766.4526455634823,30165.986566097938,5215476.0,0.0,1.19993537E8,832.4906478513752,29607.06057486459,5009694.0,0.0,1,0,0,0,3139240,2888528,1304.708344205903,1201.1583433429862,0.0,1460.0,1292.7911707487333,454.0610382102013,206171.42642052585,0,0,0,17285,300704,0,0,0,0.0,1292.7954699638183,1313.0829687350301,1270.7584345666337,0,0,0,17670374,12584,5586459,7116,9344674,6551,8325720,2440,1308,145831,20,7815915.0,0.0,7815915.0,7815915.0,5009694.0,0.0,5009694.0,5009694.0,1
192.168.1.4-192.168.1.5-49206-445-6,192.168.1.4,49206,192.168.1.5,445,6,01/01/1970 08:16:44 AM,119971085,314029,316610,4.10129634E8,4.08504426E8,1460.0,0.0,1306.0247110935975,439.82789152818407,1460.0,0.0,1290.2448627649014,453.1767821306647,6823594.702006738,5256.591619555662,190.23764029442714,6530.541952679695,2386002.0,0.0,1.19971085E8,382.0394518960102,10353.983350943603,2600175.0,0.0,1.19970561E8,378.9234071046582,9254.757002842347,2386002.0,0.0,0,0,0,0,6284432,6343900,2617.539051180541,2639.052568375121,0.0,1460.0,1298.1027527590732,446.64856167369055,199494.93764517657,0,0,0,36414,630639,0,0,0,1.0,1298.1048111518635,1306.0247110935613,1290.2448627649158,0,0,0,102329257,72883,7580980,62805,82025926,63322,81700885,1308,1188,291767,20,0,0,0,0,0,0,0,0,1
192.168.1.4-192.168.1.5-49206-445-6,192.168.1.4,49206,192.168.1.5,445,6,01/01/1970 08:18:44 AM,119999994,317783,325664,4.13091335E8,4.1244597E8,1460.0,0.0,1299.9164052199599,444.99995312419304,1460.0,0.0,1266.4770131178414,477.10984194312726,6879477.885640561,5362.058601436263,186.495827155659,4056.044618390739,1666468.0,0.0,1.19999452E8,377.6156358761728,6687.658187325375,1880275.0,0.0,1.19988672E8,368.4442874996502,5900.8865657548695,1666468.0,0.0,1,0,0,0,6362500,6524780,2648.1917990762568,2713.8668023600067,0.0,1460.0,1282.9904467805175,461.83433830960723,213290.95604187273,0,0,0,43669,643447,0,0,0,1.0,1282.9924407138428,1299.9164052199142,1266.4770131178147,0,0,0,275179101,198029,7073251,158891,206545667,162832,206222985,1187,3366,297013,20,0,0,0,0,0,0,0,0,1
192.168.1.4-192.168.1.5-49206-445-6,192.168.1.4,49206,192.168.1.5,445,6,01/01/1970 08:20:44 AM,118844391,225911,290147,2.67065494E8,3.69384161E8,1460.0,0.0,1182.1712709872804,550.3381130500704,1460.0,0.0,1273.0931596742096,458.43427881419535,5355319.251036424,4342.30000808368,230.2931478499433,6808.639487247515,4479859.0,0.0,1.18844391E8,526.0696339250142,10523.536974801536,4479859.0,0.0,1.18640321E8,408.8986958289939,9452.315165590087,4694686.0,0.0,0,0,0,0,4521640,5810032,1900.8974516937867,2441.402556389893,0.0,1460.0,1233.2913775362993,502.7730919894708,252780.78202865287,0,0,0,57504,516058,0,0,0,1.0,1233.2937673672338,1182.1712709872472,1273.0931596742341,0,0,0,318224827,238688,5585227,225911,267065494,290147,369384161,3366,255,204436,20,0,0,0,0,0,0,0,0,1
192.168.1.4-192.168.1.5-49206-445-6,192.168.1.4,49206,192.168.1.5,445,6,01/01/1970 08:22:47 AM,12534539,1357,1354,124568.0,173312.0,92.0,0.0,91.79661016949152,4.322530021493275,128.0,128.0,128.0,0.0,23764.735184915855,216.28238581410932,4625.291143911445,146155.73855231126,5473074.0,0.0,1.2534539E7,9243.760324483783,206555.46925162448,5473074.0,0.0,1.2335732E7,9117.318551367334,215338.20718223997,5682517.0,0.0,1,0,0,0,27140,27080,108.26086224630997,108.02152356779933,0.0,128.0,109.87168141592927,18.36121986977281,337.13439510613983,0,0,0,2708,2711,0,0,0,0.0,109.91220951678348,91.79661016949153,128.0,0,0,0,99293,902,262799,678,62284,677,86656,26915,252,1353,20,623786.5,139054.66984067814,722113.0,525460.0,5373658.5,140594.74841010242,5473074.0,5274243.0,1
192.168.1.4-192.168.1.5-49206-445-6,192.168.1.4,49206,192.168.1.5,445,6,01/01/1970 08:25:00 AM,575,2,0,1.0,0.0,1.0,0.0,0.5,0.7071067811865476,0,0,0,0,1739.1304347826087,3478.2608695652175,575.0,0.0,575.0,575.0,575.0,575.0,0.0,575.0,575.0,0,0,0,0,0,0,0,0,0,52,0,3478.2608695652175,0.0,0.0,1.0,0.6666666666666667,0.5773502691896257,0.3333333333333333,0,0,0,0,2,0,0,0,0.0,1.0,0.5,0.0,0,0,0,0,0,0,0,0,0,0,252,0,0,20,0,0,0,0,0,0,0,0,1
192.168.1.4-192.168.1.5-49206-445-6,192.168.1.4,49206,192.168.1.5,445,6,01/01/1970 08:27:00 AM,472,2,0,1.0,0.0,1.0,0.0,0.5,0.7071067811865476,0,0,0,0,2118.64406779661,4237.28813559322,472.0,0.0,472.0,472.0,472.0,472.0,0.0,472.0,472.0,0,0,0,0,0,0,0,0,0,52,0,4237.28813559322,0.0,0.0,1.0,0.6666666666666667,0.5773502691896257,0.3333333333333333,0,0,0,0,2,0,0,0,0.0,1.0,0.5,0.0,0,0,0,0,0,0,0,0,0,0,252,0,0,20,0,0,0,0,0,0,0,0,1
192.168.1.4-192.168.1.5-49206-445-6,192.168.1.4,49206,192.168.1.5,445,6,01/01/1970 08:29:00 AM,119999939,2,1,1.0,1.0,1.0,0.0,0.5,0.7071067811865476,1.0,1.0,1.0,0.0,0.016666675138893194,0.025000012708339795,5.99999695E7,8.48518329852802E7,1.19999276E8,663.0,663.0,663.0,0.0,663.0,663.0,0,0,0,0,0,0,0,0,0,52,20,0.016666675138893194,0.008333337569446597,0.0,1.0,0.75,0.49999999999999994,0.24999999999999997,0,0,0,0,3,0,0,0,0.0,1.0,0.5,1.0,0,0,0,0,0,0,2,1,1,1,252,252,0,20,663.0,0.0,663.0,663.0,1.19999276E8,0.0,1.19999276E8,1.19999276E8,1
192.168.1.4-192.168.1.5-49206-445-6,192.168.1.4,49206,192.168.1.5,445,6,01/01/1970 08:31:00 AM,119998935,2,1,0.0,1.0,0.0,0.0,0.0,0.0,1.0,1.0,1.0,0.0,0.008333407292323052,0.025000221876969157,5.99994675E7,8.485138609379448E7,1.19998458E8,477.0,1.19998935E8,1.19998935E8,0.0,1.19998935E8,1.19998935E8,0,0,0,0,0,0,0,0,0,64,20,0.016666814584646104,0.008333407292323052,0.0,1.0,0.25,0.5,0.25,0,0,0,0,3,0,0,0,0.0,0.3333333333333333,0.0,1.0,0,0,0,0,0,0,2,0,1,1,16233,252,0,32,0,0,0,0,1.19998458E8,0.0,1.19998458E8,1.19998458E8,1
192.168.1.4-192.168.1.5-49206-445-6,192.168.1.4,49206,192.168.1.5,445,6,01/01/1970 08:35:00 AM,119999973,2,1,1.0,1.0,1.0,0.0,0.5,0.7071067811865476,1.0,1.0,1.0,0.0,0.01666667041666751,0.025000005625001265,5.99999865E7,8.485216815389448E7,1.1999953E8,443.0,443.0,443.0,0.0,443.0,443.0,0,0,0,0,0,0,0,0,0,52,20,0.01666667041666751,0.008333335208333756,0.0,1.0,0.75,0.49999999999999994,0.24999999999999997,0,0,0,0,3,0,0,0,0.0,1.0,0.5,1.0,0,0,0,0,0,0,2,1,1,1,252,252,0,20,443.0,0.0,443.0,443.0,1.1999953E8,0.0,1.1999953E8,1.1999953E8,1
192.168.1.4-192.168.1.5-49206-445-6,192.168.1.4,49206,192.168.1.5,445,6,01/01/1970 08:37:00 AM,119999622,1,1,0.0,1.0,0.0,0.0,0.0,0.0,1.0,1.0,1.0,0.0,0.00833335958341602,0.01666671916683204,1.19999622E8,0.0,1.19999622E8,1.19999622E8,0,0,0,0,0,0,0,0,0,0,0,0,0,0,32,20,0.00833335958341602,0.00833335958341602,0.0,1.0,0.3333333333333333,0.5773502691896257,0.3333333333333333,0,0,0,0,2,0,0,0,1.0,0.5,0.0,1.0,0,0,0,0,0,0,1,0,1,1,16233,252,0,32,0,0,0,0,1.19999622E8,0.0,1.19999622E8,1.19999622E8,1
192.168.1.4-192.168.1.5-49206-445-6,192.168.1.4,49206,192.168.1.5,445,6,01/01/1970 08:39:00 AM,119999405,2,1,0.0,1.0,0.0,0.0,0.0,0.0,1.0,1.0,1.0,0.0,0.008333374652982655,0.025000123958947965,5.99997025E7,8.485220916608779E7,1.19999275E8,130.0,1.19999405E8,1.19999405E8,0.0,1.19999405E8,1.19999405E8,0,0,0,0,0,0,0,0,0,64,20,0.01666674930596531,0.008333374652982655,0.0,1.0,0.25,0.5,0.25,0,0,0,0,3,0,0,0,0.0,0.3333333333333333,0.0,1.0,0,0,0,0,0,0,2,0,1,1,16233,252,0,32,0,0,0,0,1.19999275E8,0.0,1.19999275E8,1.19999275E8,1
